01 02 03 04 05 06 07 08
09 10 11 12 13 14 15 16
17 18 19 20 21 22 23 24
25 26 27 28 29 30 31 32
33 34 35 36 37 38 39 40
31 42 43 44 42 8c 04 08 
01 02 03 04 fb 2d 4c 3b 0a